1 1 2 x 2 0 0 0 0 0 0 0 0 0 0 0
x 1 2 x 2 0 0 0 0 0 0 1 1 2 1 1
1 2 2 2 1 0 1 1 1 0 0 2 x 3 x 2
0 1 x 1 0 0 1 x 1 0 0 3 x 4 2 x
0 2 2 2 0 0 1 1 1 0 0 2 x 2 1 1
1 2 x 1 0 0 0 0 0 0 0 1 1 1 0 0
1 x 2 2 1 1 0 0 0 0 0 0 0 0 0 0
1 1 1 1 x 1 0 0 0 0 0 0 0 0 0 0