0 0 0 0 1 1 1 1 1 1
0 0 0 1 2 x 2 2 x 1
0 1 1 2 x 2 2 x 2 1
1 2 x 2 1 1 1 1 1 0
1 x 2 1 0 0 0 0 0 0
1 1 1 0 0 0 0 0 0 0