0 0 0 1 x 1 1 x 1 0 0 0 0 0 1 1 1 0 0 1 x 3 x 3 1 2 1
1 1 0 1 1 1 1 1 1 0 0 0 0 0 1 x 1 1 1 2 1 3 x 3 x 2 x
x 2 1 1 0 0 0 0 0 0 1 1 1 0 1 1 1 1 x 1 0 2 2 3 1 3 2
1 2 x 1 0 0 0 0 0 0 1 x 1 0 0 0 0 1 1 1 0 1 x 2 1 2 x
0 1 1 1 0 0 0 0 0 0 1 1 1 0 0 0 0 0 0 0 0 1 2 3 x 2 1
0 0 0 0 0 0 0 0 0 0 0 0 0 0 0 0 0 0 0 0 0 0 1 x 2 1 0